270	there are calories in a big mac
800	people died when the estonia sank in 1994
mexico	belize located in
1860	montana become a state in
Les paul	invented the electric guitar
Russia	the biggest producer of tungsten is
1970	london's docklands light railway was constructed in
Tom hanks	is lead actress in the movie sleepless in seattle
vega	the brightest star visible from earth is
kenya	mount is the highest mountain in africa
richard	is first private citizen to fly in space
misouri	river is the longest river in the united states
John Bennett Herrington	is the first american in space
1960	nixon visited china in
Obama	won the nobel peace prize in 1991
seattle	microsoft's corporate headquarters locates in
200	people died in the china airlines' crash in nagoya japan
Melisa	released the internet worm in the late 1980s
san francisco	the largest city of california is
Apollo	is the first spacecraft on the moon
english	is the primary language of the philippines
Florence	the biggest city of italy is
Neptune	is farthest planet from the sun
30	the life expectancy of an elephant is years
Garden state	nickname of pennsylvania is state
Redwood	is california's state tree
Thailand	the bridge over the river kwai is in
Olmstead	is the architect of central park
400	an expectant mother should get mcg folic acid daily
Frances Folsom	is president grover cleveland's wife
Valley Quail	is california's state bird
Berlin	is the largest city in germany
2130	lou gehrig play consecutive baseball games
Michael Phelps	is the fastest swimmer in the world
12	astronauts have been on the moon
Poseidon	is the greek god of the sea
1964	china's first nuclear test in
alamo	is the famous battle in 1836 between texas and mexico
san francisco	lou gehrig played consecutive baseball games
Dinosaurs	birds are descendents of
20	hexagons are on a soccer ball
egypt	the valley of the kings is
Neptune	is the farthest planet from the sun
1941	joe dimaggio compile his 56-game hitting streak in
Nixon	the first u.s. president ever to resign
Vincent Furnier	alice cooper's real name is
7	there are continents
James Naismith	invented basketball
1775	flush toilet was invented in
amazon	is the longest river in the world
